11111111111111111111111111
10000P00000000000010000001
10000000000011000000000001
100000000000000000000C00E1
11111111111111111111111111