NO      ./resources/textures/vwall.xpm



     SO ./resources/textures/gate.xpm

     
EA            ./resources/textures/port.xpm
     WE        ./resources/textures/piping.xpm





F       0,01,0






C 0,02,50




 111111111111111111111111111111111111
100000E000000000001000000000000000000111111111111
1000000000000000000000000000000000000000000011
111100111111111000000000000000001111111111111
11111111     1111111111111111111
   