11111111111111111111111111
10000001000011000010000001
10111111111011000000000001
10000000000000000000000001
10000000000000001000000001
10000000N00000000000000001
10000001000011000010000001
10111111111011000001110001
10000000000000000000000001
11111111111111111101111111
10000000000000000000000001
10000001000011000010000001
10111111111011000001110001
10000000000000000000000001
11111111111111111111111111